**********
X*****XXX*
X*****XXX*
XXXX**XXX*
XXXXX***X*
XXXXXX**X*
XXXXXX*XX*
XXXXXX****
XXXXXXX***
XXXXXXX***