********X****XX******
*********X***XX***X**
***X*X*********X*X*X*
*******X***X******X*X
**X*XXXX*X**X*X*X**XX
*********XX*X***X*X**
***X*X**XX***X**X***X
*X***X*X***X*X*XX***X
****XX***XXX***XXX*XX
**X****X**XX*X***X***
**XX**XX**XX*X***X*XX
X**X*X*X**XX**X*XX***
***X**X***XXX**XXX**X
X*X**X*X**X******X***
****X**X*******X****X
X***X******X*X***X*X*
***XX*XXX*******X***X
X*****XXX*X*****XXX**
***X*******XX*X*XXXX*
*X***XX*X**XXXX*****X
*XX*X*XX*************
