**********
X*****XXX*
X*****X?X*
XXXX**XXX*
XXXXX***X*
XXXXXX**X*
XXXXXX*XX*
XXXXXX****
XXXXXXX***
XXXXXXX***